## ######################################################
#                #         #      #       ############# #
# ########### ######## ### # #### # ### #             # #
#     #     #            # # #    #   # ############# # #
### ### ############ ##### # ### #### # #           # # #
#       # #        # #     #   #    # # # ######### # # #
##### ### ##### ## # # ####### ######## # #       # # # #
#               #  # # #                # # ##### # # # #
####### ############ # # ################ # #     # # # #
#     # #    # #     # #            #   # # # ##### # # #
# ### # #### # ####### ############ # # # # #       # # #
# # # #      # ###   #              ### # # ######### # #
# # # ### ####     ######### ########   # #           # #
# # # # ### ### ##  ######     #  # # ### ############# #
#   #            ##        ## ###                       #
###################################################### ##
